CCCCCCCCCCCCCCCCCCCCCCCCC
C  1+++ CC +++ CC +++2  C
C+C+CCC    CCC    CCC+C+C
C+C+CCCCCC+CCC+CCCCCC+C+C
C+C   CCCC CCC CCCC   C+C
C+C C  +++  X  +++  C C+C
C   CCCCCC CCC CCCCCC   C
C C CCCCCC CCC CCCCCC C C
C+C C   ++ +++ ++   C C+C
C+C ++CCCC CCC CCCC++ C+C
C+C+CCCCCC+CCC+CCCCCC+C+C
C+C+CCC ++ CCC ++ CCC+C+C
C  3 ++ CC +++ CC  ++4  C
CCCCCCCCCCCCCCCCCCCCCCCCC
