CCCCCCCCCCCCCCCCCCCCCCCCC
C +++  CC  +++  CC  +++ C
C+CCCC CC CCCCC CC CCCC+C
C+CCCC ++  +++  ++ CCCC+C
C 1    CCCCC+CCCCC    2 C
CC+CCC CC   X   CC CCC+CC
CC+CCC+++ CCCCC +++CCC+CC
CC+CCCCCC CCCCC CCCCCC+CC
CC ++ CCC+ +++ +CCC ++ CC
CC CC+CCC+CCCCC+CCC+CC CC
C++CC+CC  C + C  CC+CC++C
C CCC+CC CC C CC CC+CCC C
C +++3   ++ C ++   4+++ C
CCCCCCCCCCCCCCCCCCCCCCCCC
