CCCCCCCCCCCCCCCCCCCCCCCCC
C++  1+ ++++ ++++ +2  ++C
C+CCC CCCCCCCCCCCCC CCC+C
C+CCC+CCCCCCCCCCCCC+CCC+C
C+CCC+CCCC +++ CCCC+CCC+C
C CCC CCCC C C CCCC CCC C
C+ 4 + +++ C C +++ + 3 +C
C C CCCCCCCC+CCCCCCCC C C
C C+CCCCCCCC CCCCCCCC+C C
C+   +++  CC CC  +++   +C
C CCC CCC  +++  CCC CCC C
C+CCC CCC CCCCC CCC CCC+C
C  ++++++   X   ++++++  C
CCCCCCCCCCCCCCCCCCCCCCCCC
